F 0,0,1
C 0,126,2
EA ./textures/east_texture.xpm
WE ./textures/west_texture.xpm
SO ./textures/south_texture.xpm
NO ./textures/north_texture.xpm

        1111111111111111111111111
        1000000000010000000000001
        101100000101000000000001
        1001000000000000000000001
111111111011000000010000000000001
100000000011000001010100011111111
11110111111111011100000010001
11110111111111011101010010001
11000000110101011100000010001
10000000000000001100000010001
10000000000000001101010010001
110000011101010111010111000111
11110111 1110101 101N11101001
11111111 1111111 111111111111